가내영	base
가득염	base
간미연	sing
감병석	pd
감병훈	base
감우성	tal
강경란	pd
강관선	pd
강규철	base
강근식	wrscn
강기영	sing
강기중	bask
강남길	tal
강남준	pd
강대영	pd
강대협	bask
강대희	foot
강동길	pd
강동우	base
강동원	tal
강동희	bask
강두	sing
강리나	tal
강만수	vol
강만희	tal
강문영	tal
강미선	vol
강민경	tal
강민규	base
강민정	bask
강병규	mc
강병문	pd
강병수	bask
강병철	base
강봉규	base
강부길	pd
강부자	tal
강산들	foot
강산에	sing
강상수	base
강석	gag
강석	mc
강석우	tal
강석천	base
강석현	tal
강선모	pd
강성곤	mc
강성범	gag
강성연	tal
강성우	base
강성철	pd
강성형	vol
강성훈	sing
강수연	tal
강수정	mc
강수지	sing
강승원	sing
강신성일	tal
강양택	bask
강연희	mc
강영숙	bask
강영원	pd
강영은	mc
강영은	pd
강원래	sing
강인구	sing
강인권	base
강인봉	sing
강인원	sing
강일석	pd
강재형	mc
강재형	pd
강정길	base
강정수	bask
강준호	foot
강지숙	bask
강철	foot
강철민	base
강철수	wrscn
강철용	pd
강철호	pd
강타	sing
강혁	base
강혁	bask
강현국	pd
강현근	pd
강현수	sing
강혜미	vol
강호동	gag
강효실	tal
강희석	base
강희원	pd
견미리	tal
경명철	pd
경운현	mc
경헌호	base
계수남	sing
계은숙	sing
고대원	sing
고대화	pd
고동선	pd
고두심	tal
고명환	gag
고민구	pd
고민정	vol
고병희	sing
고복수	sing
고봉황	wrscn
고석만	pd
고성균	pd
고성옥	mc
고성주	wrplay
고소영	tal
고수	tal
고영수	gag
고영욱	sing
고영준	sing
고운봉	sing
고은아	tal
고은아	vol
고장석	pd
고재근	sing
고재정	pd
고정운	foot
고종수	foot
고지용	sing
고창근	mc
고학찬	pd
고현민	tal
고현정	tal
고호경	sing
고호경	tal
고희일	pd
공병억	pd
공부영	mc
공영화	pd
공유	tal
공재성	pd
공정민	mc
공형진	tal
공효진	tal
곽경근	foot
곽기완	bask
곽기원	pd
곽남희	vol
곽명세	pd
곽미란	vol
곽영범	pd
곽윤종	sing
곽인식	foot
곽인행	wrscn
곽지민	tal
곽진영	tal
곽창선	sing
곽채진	base
곽치근	pd
곽현식	tal
곽현희	base
구기란	vol
구대성	base
구민정	vol
구민호	base
구병두	bask
구본근	bask
구본근	pd
구본승	sing
구본승	tal
구봉서	gag
구선경	wrscn
구자운	base
구준엽	sing
구지숙	wrscn
구창모	sing
구천서	base
구태훈	sing
구현숙	wrscn
국정환	tal
국혜정	mc
궁선영	mod
궁선영	tal
권경일	pd
권기경	wrscn
권기선	tal
권명철	base
권미혜	tal
권민중	tal
권상우	tal
권석장	pd
권선국	sing
권순우	pd
권순찬	vol
권영찬	gag
권오명	sing
권오석	pd
권오성	pd
권오승	pd
권오준	base
권오중	tal
권용관	base
권용복	base
권용택	pd
권윤민	base
권은아	tal
권은정	bask
권이상	pd
권익준	pd
권인하	sing
권재영	pd
권재희	tal
권중오	bask
권진원	sing
권찬수	foot
권해창	foot
권해효	tal
권혁범	vol
권황택	pd
금보라	tal
기민수	pd
기용일	vol
기호영	foot
길도익	bask
길용우	tal
길은정	mc
길은정	sing
길환영	pd
김가연	tal
김갑수	pd
김갑제	vol
김강윤	wrscn
김건모	sing
김건형	foot
김경기	base
김경란	mc
김경문	base
김경식	gag
김경식	pd
김경원	base
김경자	vol
김경태	foot
김경호	sing
김경희	bask
김관규	foot
김관동	mc
김광림	base
김광민	sing
김광삼	base
김광석	sing
김광수	foot
김광식	pd
김광운	bask
김광진	sing
김광태	pd
김광희	pd
김구	sing
김구산	pd
김구철	vol
김국진	gag
김귀현	vol
김규리	tal
김규선	vol
김규완	wrscn
김규홍	pd
김규효	pd
김기남	foot
김기덕	base
김기덕	pd
김기동	foot
김기만	bask
김기만	mc
김기범	foot
김기복	foot
김기원	pd
김기중	vol
김기태	base
김기형	foot
김기흥	pd
김길환	pd
김나연	bask
김나운	tal
김남규	pd
김남순	vol
김남원	pd
김남일	foot
김남주	tal
김남진	tal
김대건	foot
김대우	wrscn
김대의	foot
김대익	base
김대철	foot
김대현	bask
김대현	foot
김대환	foot
김도균	foot
김도근	foot
김도명	bask
김도연	tal
김도용	foot
김도향	sing
김도훈	foot
김동건	mc
김동광	bask
김동률	sing
김동성	pd
김동수	base
김동언	bask
김동우	mc
김동욱	bask
김동운	pd
김동주	base
김동철	pd
김두삼	wrscn
김래원	tal
김래호	pd
김만진	pd
김만후	base
김명곤	foot
김명곤	tal
김명세	pd
김명수	tal
김명철	tal
김명호	pd
김무생	tal
김묵	wrscn
김미숙	tal
김미연	gag
김미화	gag
김민	tal
김민기	sing
김민범	base
김민선	tal
김민식	pd
김민자	tal
김민정	tal
김민종	sing
김민종	tal
김민주	tal
김민호	pd
김민희	tal
김범도	mc
김범석	pd
김범수	sing
김병국	pd
김병래	mc
김병세	tal
김병수	wrscn
김병지	foot
김병진	pd
김병찬	mc
김병천	bask
김병철	bask
김병철	vol
김병현	base
김보민	bask
김보민	mc
김보애	tal
김봉연	base
김부석	foot
김분좌	bask
김사랑	sing
김사랑	tal
김사율	base
김상경	tal
김상근	pd
김상렬	wrplay
김상문	foot
김상수	wrplay
김상순	tal
김상식	bask
김상우	bask
김상우	vol
김상준	mc
김상중	tal
김상진	base
김상태	gag
김상현	pd
김상호	base
김상훈	base
김상훈	foot
김상희	sing
김서라	tal
김서연	vol
김석윤	pd
김석환	pd
김석훈	tal
김석희	pd
김선경	sing
김선경	tal
김선동	mc
김선민	tal
김선섭	base
김선아	sing
김선아	tal
김선아	vol
김선우	base
김선진	base
김성규	foot
김성근	base
김성근	pd
김성길	pd
김성래	base
김성령	tal
김성모	bask
김성묵	pd
김성민	wrscn
김성수	sing
김성연	pd
김성우	pd
김성우	vol
김성원	tal
김성은	mc
김성응	pd
김성제	foot
김성주	mc
김성중	pd
김성채	vol
김성철	bask
김성택	tal
김성한	base
김성현	base
김성홍	wrscn
김성환	bask
김성환	pd
김성환	tal
김성희	vol
김세영	pd
김세인	foot
김세준	tal
김세진	vol
김세환	sing
김소연	tal
김소원	mc
김소이	tal
김수경	base
김수동	pd
김수로	tal
김수룡	pd
김수미	tal
김수아	pd
김수일	pd
김수정	tal
김수철	sing
김수현	pd
김수희	sing
김순호	foot
김승기	bask
김승민	tal
김승수	tal
김승우	tal
김승종	pd
김승현	bask
김승현	mc
김승현	mod
김승환	pd
김시연	pd
김시진	base
김애경	tal
김양화	pd
김여진	tal
김연심	vol
김연자	sing
김연주	mc
김연주	mod
김연중	base
김연진	pd
김영도	pd
김영란	tal
김영렬	pd
김영만	bask
김영문	pd
김영미	vol
김영배	sing
김영배	tal
김영석	pd
김영선	foot
김영선	pd
김영수	base
김영애	tal
김영옥	bask
김영용	pd
김영진	pd
김영철	gag
김영철	pd
김영현	wrscn
김영호	pd
김영희	pd
김예분	mc
김예분	tal
김옥균	pd
김완선	sing
김완태	mc
김용관	pd
김용대	foot
김용만	gag
김용석	pd
김용수	base
김용수	pd
김용식	bask
김용옥	wrscn
김용재	pd
김용해	pd
김용휘	base
김우룡	pd
김우상	pd
김우선	pd
김욱한	pd
김웅래	pd
김원용	pd
김원준	sing
김원진	pd
김원형	base
김원희	tal
김유미	tal
김유진	vol
김유철	pd
김유택	bask
김윤경	tal
김윤대	pd
김윤아	sing
김윤영	pd
김윤정	vol
김윤정	wrscn
김윤지	mc
김윤진	tal
김윤한	mc
김윤호	bask
김은석	foot
김은성	mc
김은아	vol
김은정	tal
김은주	mc
김은중	foot
김을동	tal
김응국	base
김응석	tal
김의경	pd
김의환	gag
김이지	sing
김인건	bask
김인식	base
김인영	wrscn
김인우	foot
김일진	foot
김일훈	pd
김자영	mc
김자옥	tal
김장훈	sing
김재박	base
김재신	foot
김재영	foot
김재원	mc
김재원	tal
김재준	pd
김재진	pd
김재하	base
김재현	base
김재형	pd
김재훈	bask
김정구	sing
김정규	pd
김정균	tal
김정렬	gag
김정무	base
김정민	sing
김정민	tal
김정수	base
김정수	pd
김정숙	wrplay
김정식	gag
김정욱	pd
김정은	pd
김정은	tal
김정인	bask
김정지	pd
김정학	pd
김정혁	foot
김정현	tal
김정화	tal
김정환	pd
김정훈	sing
김제동	mc
김조한	sing
김종국	sing
김종만	base
김종서	sing
김종선	pd
김종섭	pd
김종성	pd
김종식	pd
김종윤	base
김종창	pd
김종학	pd
김종헌	base
김종현	pd
김종화	vol
김종환	sing
김종흥	bask
김주성	bask
김주승	tal
김주영	wrscn
김주완	pd
김주찬	base
김주하	mc
김주혁	tal
김준석	foot
김준연	mc
김준환	base
김중기	tal
김지미	tal
김지선	gag
김지수	tal
김지수	vol
김지수	wrscn
김지영	tal
김지완	pd
김지우	tal
김지운	foot
김지윤	bask
김지윤	foot
김지윤	mc
김지은	mc
김지헌	wrscn
김지혜	vol
김지호	tal
김지훈	sing
김진	bask
김진	sing
김진	tal
김진수	gag
김진우	base
김진우	foot
김진이	vol
김진표	sing
김진호	pd
김진홍	pd
김진환	pd
김찬우	tal
김창기	sing
김창수	pd
김창숙	tal
김창완	sing
김창완	tal
김창준	gag
김창헌	vol
김창희	base
김채연	tal
김철규	pd
김철석	pd
김철수	pd
김철용	vol
김청	tal
김충	base
김충	pd
김충길	pd
김충민	base
김태규	mc
김태균	base
김태균	gag
김태기	pd
김태석	base
김태연	mod
김태연	tal
김태영	foot
김태영	pd
김태우	sing
김태우	tal
김태욱	pd
김태욱	sing
김태종	vol
김태진	bask
김태진	foot
김태호	pd
김태환	bask
김태훈	sing
김태희	mc
김태희	tal
김하늘	tal
김학	pd
김학도	gag
김학래	gag
김학삼	pd
김학영	pd
김학철	tal
김한국	gag
김한수	base
김한영	pd
김한욱	foot
김한윤	foot
김한철	pd
김해숙	tal
김향숙	vol
김현	pd
김현민	base
김현서	pd
김현수	foot
김현수	tal
김현숙	pd
김현영	gag
김현우	foot
김현욱	base
김현욱	mc
김현자	vol
김현정	sing
김현종	pd
김현주	tal
김현주	vol
김현준	bask
김현준	pd
김현철	gag
김현철	sing
김현태	mc
김형곤	gag
김형일	pd
김형일	tal
김형자	tal
김혜리	tal
김혜림	sing
김혜수	tal
김혜연	mc
김혜영	vol
김혜자	tal
김혜정	tal
김혜정	wrscn
김호	foot
김호곤	foot
김호상	pd
김호준	mc
김호진	tal
김호철	vol
김홍성	mc
김홍종	pd
김홍집	base
김홍표	tal
김화순	bask
김화영	bask
김환균	pd
김효진	gag
김효진	tal
김훈	bask
김흥경	pd
김흥섭	pd
김흥수	mc
김희갑	tal
김희경	vol
김희권	pd
김희규	vol
김희라	tal
김희무	pd
김희선	bask
김희선	mod
김희선	tal
김희수	mc
김희숙	sing
김희애	tal
김희재	wrscn
김희철	mc
나경미	tal
나문희	tal
나미	sing
나소운	wrscn
나소원	wrscn
나얼	sing
나에스더	bask
나영희	tal
나한일	tal
나현희	sing
나현희	tal
나훈아	sing
남궁옥분	sing
남궁원	tal
남궁찬	pd
남기석	pd
남기성	foot
남기일	foot
남기헌	base
남능미	tal
남만원	wrscn
남성우	pd
남성진	tal
남성훈	tal
남인수	sing
남일우	tal
남주희	tal
남진	sing
남희석	gag
노경식	wrplay
노경주	tal
노기석	bask
노민혁	sing
노병현	pd
노사연	sing
노상래	foot
노영국	tal
노영심	sing
노유경	wrscn
노장진	base
노정윤	foot
노정팔	pd
노종면	pd
노주현	tal
노진수	vol
노찬엽	base
노창곡	pd
노태경	foot
노현정	mc
노현희	tal
노희경	wrscn
데니안	sing
도성아	sing
도신우	mod
도지원	tal
독고성	tal
독고영재	tal
동완	sing
로버트 벤튼	wrscn
류명준	pd
류수영	tal
류승범	tal
류시원	sing
류시원	tal
류시현	mc
류시형	pd
류영수	base
류용렬	foot
류웅렬	foot
류은혜	vol
류제국	pd
류현승	base
리아	sing
리치	sing
릭윤	mod
마이키 조	sing
마일영	base
마해영	base
마호길	mc
맹만재	pd
맹상훈	tal
명계남	tal
명국환	sing
명노진	tal
명세빈	tal
명승희	wrscn
명중재	vol
모은설	wrscn
문경은	bask
문도영	foot
문동환	base
문보현	pd
문삼진	foot
문성근	tal
문소리	tal
문수복	pd
문시형	pd
문영남	wrscn
문오장	tal
문주란	sing
문지원	vol
문창환	base
문천식	gag
문태혁	foot
문혜숙	vol
문희성	base
문희옥	sing
문희준	sing
민경삼	base
민경욱	mc
민병근	foot
민용기	pd
민욱	tal
민해경	sing
바다	sing
박강조	foot
박건삼	pd
박건식	pd
박건연	bask
박건하	foot
박경규	foot
박경림	gag
박경완	base
박경진	base
박경추	mc
박경희	mc
박광덕	gag
박광우	wrscn
박광현	tal
박광호	bask
박광호	pd
박광희	pd
박규채	tal
박규현	bask
박규훈	bask
박근형	tal
박금숙	vol
박기범	base
박기영	sing
박기현	pd
박나림	mc
박남열	foot
박남정	sing
박노식	tal
박노원	mc
박도경	bask
박도환	pd
박동선	pd
박동우	foot
박동주	pd
박동혁	foot
박동희	base
박만영	pd
박명규	pd
박명수	gag
박명수	sing
박명애	bask
박명종	pd
박명환	base
박문영	pd
박미경	sing
박미경	vol
박미선	gag
박민서	foot
박민영	foot
박범수	wrscn
박병웅	pd
박보융	pd
박보현	base
박복만	pd
박봉성	pd
박사임	mc
박상관	bask
박상규	mc
박상규	sing
박상면	tal
박상민	sing
박상민	tal
박상신	foot
박상아	tal
박상욱	bask
박상원	tal
박상인	foot
박상일	pd
박상준	pd
박상혁	pd
박상환	pd
박상희	sing
박석원	pd
박석진	base
박선미	vol
박선영	bask
박선영	tal
박선출	vol
박성미	tal
박성배	bask
박성배	foot
박성봉	mc
박성수	pd
박성식	sing
박성연	sing
박성진	base
박성철	sing
박성혜	wrscn
박성화	foot
박성훈	sing
박세민	gag
박세웅	bask
박세준	tal
박소현	tal
박솔미	tal
박수교	bask
박수동	pd
박수림	gag
박수용	pd
박수정	vol
박수창	pd
박수홍	gag
박순애	tal
박순양	bask
박순천	tal
박승배	pd
박승호	base
박승화	sing
박승희	wrplay
박시은	tal
박신양	tal
박신영	foot
박신자	bask
박양원	pd
박언희	wrscn
박연규	pd
박영규	pd
박영규	tal
박영만	mc
박영미	sing
박영순	foot
박영주	mc
박영주	pd
박영호	foot
박영호	pd
박영환	mc
박예진	tal
박옥상	wrscn
박용구	wrplay
박용근	sing
박용기	pd
박용식	tal
박용우	tal
박용재	wrplay
박용진	wrscn
박용택	base
박용하	tal
박용호	mc
박웅	tal
박원길	foot
박원숙	tal
박원웅	pd
박은영	tal
박은혜	tal
박인규	bask
박인환	tal
박장규	pd
박재용	base
박재일	bask
박재헌	bask
박재현	bask
박재홍	base
박재홍	foot
박재훈	tal
박정규	pd
박정근	pd
박정미	pd
박정석	foot
박정수	tal
박정숙	mc
박정아	sing
박정우	wrscn
박정운	sing
박정은	bask
박정태	base
박정현	sing
박정화	wrscn
박정환	foot
박정훈	pd
박종기	pd
박종덕	bask
박종묵	foot
박종세	mc
박종찬	vol
박주미	tal
박주아	mc
박주언	base
박주호	foot
박준규	tal
박준석	bask
박준용	bask
박준형	sing
박준호	pd
박준홍	pd
박중훈	tal
박지성	foot
박지영	tal
박지윤	sing
박지현	bask
박진만	base
박진섭	foot
박진성	tal
박진영	sing
박진철	base
박진희	tal
박찬민	pd
박찬숙	bask
박찬숙	mc
박찬호	S
박찬홍	pd
박창순	pd
박창주	foot
박창학	pd
박철	foot
박철	tal
박철우	base
박충균	foot
박충식	base
박태경	pd
박태남	mc
박태용	pd
박태하	foot
박태호	pd
박한별	tal
박한이	base
박해선	pd
박해일	tal
박헌수	wrscn
박현석	pd
박현선	mc
박현숙	bask
박현순	pd
박현우	mc
박현주	wrscn
박현호	pd
박형숙	pd
박형주	foot
박형준	tal
박호	sing
박호진	foot
박홍균	pd
박화요비	sing
박환욱	pd
박효빈	foot
박효신	sing
박훈근	bask
박흥렬	pd
박흥영	pd
박희상	vol
반효정	tal
방신봉	vol
방열	bask
방은진	tal
방은희	tal
방지섭	vol
방지윤	bask
방현주	mc
배기성	sing
배길태	bask
배덕성	pd
배도환	tal
배동성	gag
배동순	pd
배두나	tal
배상태	pd
배용준	tal
배종옥	tal
배창복	mc
배철수	sing
배철호	pd
배칠수	gag
배한천	pd
배호	sing
백기성	base
백기홍	foot
백남규	pd
백담	pd
백명진	pd
백설희	sing
백승우	foot
백승주	mc
백승철	foot
백용철	pd
백일섭	tal
백재하	pd
백재현	gag
백재호	base
백정원	mc
백종문	pd
백종우	pd
백종학	tal
백준기	tal
백지연	mc
백지영	sing
백호민	pd
변년하	bask
변동현	pd
변소정	tal
변우민	tal
변우영	mc
변정수	mod
변진섭	sing
변혜숙	tal
보아	sing
복혜숙	tal
봉중근	base
봉하민	bask
브라이언	sing
비	sing
비키	sing
빈	tal
사강	tal
사미자	tal
사준	sing
사현진	sing
서갑숙	tal
서경석	gag
서경주	pd
서기원	mc
서기철	mc
서동명	foot
서동욱	sing
서동원	foot
서문탁	sing
서민정	mc
서병덕	pd
서상호	pd
서세원	gag
서세원	mc
서수남	gag
서수남	sing
서승만	gag
서승문	vol
서승현	tal
서용빈	base
서우림	tal
서원	tal
서유석	sing
서유정	mod
서유정	tal
서윤성	wrscn
서인석	gag
서인석	tal
서인영	sing
서장훈	bask
서재원	pd
서재응	base
서정원	foot
서정창	pd
서지영	sing
서태룡	pd
서태지	sing
서태화	tal
서한규	base
서현선	gag
서현철	pd
서효인	base
석주일	bask
석진욱	vol
석현	tal
선동렬	base
선우용녀	tal
선우은숙	tal
선우일란	tal
선우재덕	tal
설경구	tal
설기현	foot
설수진	tal
설운도	sing
설의석	base
설익찬	foot
설진아	pd
성기영	mc
성대경	pd
성동일	tal
성세정	mc
성시경	sing
성영재	base
성유리	sing
성정아	bask
성준기	pd
성지은	mc
성지은	tal
성현아	tal
세븐	sing
소수옥	pd
소유진	tal
소이현	tal
소지섭	mod
소지섭	tal
소찬휘	sing
소현경	wrscn
손동일	base
손무열	pd
손무현	sing
손미나	mc
손민한	base
손범수	mc
손상득	base
손상호	foot
손석기	mc
손석범	vol
손선자	vol
손양덕	pd
손예진	tal
손인호	base
손일석	pd
손재홍	vol
손정탁	foot
손지창	sing
손지창	tal
손진기	pd
손차훈	base
손창민	tal
손창환	bask
손태영	mc
손헌수	gag
손혁	base
손현주	tal
손현준	foot
손호영	sing
송강호	tal
송경철	tal
송경호	sing
송구홍	base
송기윤	tal
송기철	mc
송길한	wrscn
송나영	tal
송대관	sing
송만덕	vol
송문정	pd
송백경	sing
송병준	tal
송선미	mod
송선미	tal
송승준	base
송승헌	tal
송승환	tal
송시헌	sing
송신영	base
송영수	vol
송영창	tal
송옥숙	tal
송용태	tal
송윤석	foot
송윤아	tal
송은이	gag
송인득	mc
송인석	vol
송일준	pd
송재익	base
송재호	tal
송정율	pd
송종국	foot
송주희	foot
송준기	pd
송준영	pd
송중섭	pd
송지만	base
송지헌	mc
송진우	base
송창남	foot
송창식	sing
송창의	pd
송창좌	foot
송채환	tal
송태균	bask
송태영	bask
송해	mc
송혜교	tal
송홍섭	foot
수애	tal
슈	sing
신경섭	pd
신경현	base
신구	tal
신기성	bask
신대철	sing
신동건	base
신동엽	gag
신동인	pd
신동주	base
신동진	mc
신동파	bask
신동호	mc
신범철	foot
신봉승	wrscn
신선우	bask
신선호	vol
신성우	sing
신성원	mc
신성필	base
신승엽	pd
신승훈	sing
신애	mod
신애라	mc
신애라	tal
신언호	base
신영균	base
신영일	mc
신영철	vol
신완수	pd
신용균	base
신운옥	vol
신윤정	sing
신윤정	tal
신윤주	mc
신윤호	base
신은경	mc
신은경	tal
신의손	foot
신이	tal
신일룡	tal
신재웅	base
신정관	pd
신정섭	vol
신정수	pd
신정원	mc
신정자	bask
신정환	sing
신종석	bask
신종혁	foot
신주옥	pd
신주용	vol
신중현	sing
신지	sing
신진식	vol
신진원	foot
신창석	pd
신철	sing
신철인	base
신충식	tal
신카나리아	sing
신태용	foot
신하균	tal
신해성	sing
신해철	sing
신현수	pd
신현식	bask
신현준	tal
신현창	pd
신현호	foot
신형원	sing
신혜성	sing
신혜수	tal
신혜인	bask
신호균	pd
신홍기	foot
신효범	sing
실필렬	base
심갑섭	pd
심광호	base
심민석	foot
심성보	base
심수봉	sing
심양홍	tal
심영자	tal
심은진	sing
심은하	tal
심재순	wrplay
심재원	foot
심재학	base
심정수	base
심지호	tal
심택월	pd
심혁재	pd
심현섭	gag
심현우	pd
심형래	gag
심혜진	tal
싸이	sing
안경은	pd
안경현	base
안동진	pd
안문숙	tal
안병율	pd
안상길	pd
안석주	wrscn
안석환	tal
안성기	tal
안소영	tal
안수영	pd
안승인	foot
안연길	pd
안연홍	tal
안영동	pd
안용수	vol
안은영	vol
안인기	pd
안재모	tal
안재욱	tal
안정은	pd
안정환	foot
안정훈	tal
안준호	bask
안지화	vol
안치환	sing
안택호	pd
안판석	pd
안혜정	vol
안효연	foot
안희구	pd
안희봉	base
안희재	mc
앙용모	base
앤디	sing
양경민	bask
양근승	wrscn
양금석	tal
양동근	tal
양문의	bask
양미경	tal
양미라	mod
양미라	tal
양상문	base
양선영	vol
양수경	sing
양숙경	vol
양승완	wrscn
양영민	foot
양원경	gag
양원준	bask
양윤식	pd
양은성	bask
양정아	tal
양정옥	bask
양정원	foot
양종철	gag
양종후	foot
양준혁	base
양지원	foot
양진석	sing
양진웅	vol
양택조	tal
양파	sing
양현석	base
양현석	sing
양희경	tal
양희섭	pd
양희승	bask
양희연	bask
양희은	sing
어호선	pd
엄기백	pd
엄앵란	tal
엄용수	gag
엄인희	wrscn
엄정욱	base
엄정화	sing
엄정화	tal
엄지원	tal
에릭	sing
여운계	tal
여운혁	pd
여은희	wrscn
여준홍	base
여진	sing
연규진	tal
연운경	tal
연정훈	tal
연제석	bask
염경환	gag
염정아	tal
염종석	base
염현섭	pd
예랑	wrscn
예미란	pd
예민	sing
예상호	base
예지원	tal
오강선	pd
오경석	pd
오경훈	pd
오규택	base
오남열	mc
오대규	tal
오동운	pd
오명관	foot
오명식	mc
오명훈	pd
오미연	tal
오미희	mc
오미희	tal
오병훈	foot
오봉옥	base
오상민	base
오성식	bask
오세영	pd
오세웅	foot
오세학	base
오솔미	sing
오솔미	tal
오순택	tal
오승명	tal
오승범	foot
오승은	tal
오승준	base
오연수	tal
오영실	mc
오영일	base
오영진	wrscn
오용근	pd
오욱철	tal
오욱환	vol
오유경	mc
오윤경	vol
오장환	pd
오재미	gag
오정해	tal
오종록	pd
오종서	pd
오종혁	sing
오주상	base
오준석	pd
오준석	sing
오지명	tal
오진산	pd
오철민	base
오철희	base
오태석	wrplay
오태훈	mc
오한신	mc
오현경	tal
오현정	mc
오현정	tal
오현창	pd
옥소리	tal
옥주현	sing
왁스	sing
왕성상	sing
왕정현	foot
왕종근	mc
우국제	pd
우성문	foot
우성용	foot
우연석	sing
우용득	base
우정아	mc
우종범	pd
우지원	bask
우진	tal
우형순	vol
우희진	tal
운군일	pd
원미경	tal
원미연	sing
원병희	pd
원빈	tal
원석현	mc
원종덕	foot
원종배	mc
원종재	pd
위서현	mc
위성우	bask
위재영	base
유경화	vol
유근형	pd
유길촌	pd
유남수	pd
유도훈	bask
유동근	tal
유동윤	wrscn
유동주	mc
유동훈	base
유동훈	wrscn
유리	sing
유미화	vol
유민	tal
유병목	base
유병직	pd
유병택	pd
유상철	foot
유성화	pd
유수열	pd
유수호	mc
유승안	base
유승준	sing
유애리	mc
유연실	sing
유열	sing
유영석	sing
유영선	sing
유영주	bask
유영진	sing
유영춘	sing
유오성	tal
유익종	sing
유인촌	tal
유재석	gag
유재학	bask
유재혁	pd
유정아	mc
유정준	pd
유정현	mc
유제동	wrscn
유종훈	vol
유준상	tal
유중탁	vol
유지영	foot
유지인	tal
유지철	mc
유지태	mod
유지태	tal
유지현	base
유지형	wrscn
유진	sing
유진 오닐	wrplay
유진오	foot
유진월	wrplay
유태웅	tal
유택현	base
유퉁	tal
유판수	pd
유필선	base
유하영	mc
유하영	tal
유한철	wrscn
유헌	pd
유현	pd
유현미	wrscn
유현상	sing
유혜선	mc
유혜영	tal
유혜자	pd
유혜정	tal
유호석	sing
유호선	tal
유호정	tal
유호철	pd
유홍종	pd
유화석	vol
유훈근	pd
유흥렬	pd
유희열	sing
육상효	wrscn
윤건	sing
윤경진	pd
윤계상	sing
윤길룡	pd
윤남경	pd
윤다훈	tal
윤도현	sing
윤동균	base
윤동혁	pd
윤동환	tal
윤명식	pd
윤문식	tal
윤문희	pd
윤미라	tal
윤미래	sing
윤병대	pd
윤복희	sing
윤사현	pd
윤삼육	wrscn
윤상	sing
윤상무	base
윤석호	pd
윤석환	base
윤석훈	pd
윤손하	sing
윤손하	tal
윤수일	sing
윤순홍	tal
윤승원	tal
윤시내	sing
윤여정	tal
윤연선	sing
윤영관	pd
윤영미	mc
윤영필	bask
윤용구	foot
윤유선	tal
윤은혜	sing
윤인구	mc
윤인섭	pd
윤일봉	tal
윤자니	sing
윤재국	base
윤재동	pd
윤정수	gag
윤정수	pd
윤정춘	foot
윤정환	foot
윤정희	tal
윤종신	sing
윤종일	vol
윤중희	foot
윤지령	wrscn
윤지영	mc
윤진영	pd
윤철형	tal
윤태구	pd
윤태영	tal
윤학길	base
윤해영	tal
윤현진	mc
윤형주	sing
윤훈원	bask
윤흥식	pd
윤희준	foot
음정희	tal
이강돈	base
이강철	base
이강희	bask
이건열	base
이건준	pd
이경규	gag
이경근	foot
이경문	pd
이경수	base
이경수	vol
이경실	gag
이경애	gag
이경영	tal
이경윤	pd
이경재	pd
이경진	tal
이계인	tal
이계진	mc
이관우	foot
이관희	pd
이광모	wrscn
이광용	mc
이광은	base
이광환	base
이규봉	mc
이규섭	bask
이규영	mc
이규원	mc
이규임	pd
이규정	pd
이규항	mc
이규환	pd
이근욱	pd
이금보	pd
이금희	mc
이기범	foot
이기부	foot
이기재	pd
이기진	pd
이기찬	sing
이기형	foot
이길수	pd
이길용	foot
이길호	foot
이나영	mod
이나영	tal
이낙훈	tal
이남기	pd
이남헌	base
이내수	pd
이노수	pd
이달현	pd
이대근	tal
이대섭	pd
이대엽	tal
이대진	base
이덕건	pd
이덕화	tal
이도윤	pd
이동건	sing
이동건	tal
이동국	foot
이동기	pd
이동린	pd
이동석	pd
이동수	base
이동순	pd
이동우	gag
이동욱	base
이동욱	foot
이동원	sing
이동현	pd
이동희	pd
이만수	base
이매리	mc
이명기	pd
이명용	mc
이명한	pd
이명희	vol
이무영	wrscn
이문규	bask
이문세	sing
이문웅	wrscn
이문정	pd
이미선	bask
이미선	mc
이미숙	tal
이미연	tal
이미영	mc
이미영	tal
이미자	sing
이미정	vol
이미희	pd
이민경	sing
이민성	foot
이민영	tal
이민우	sing
이민우	tal
이민호	pd
이민홍	pd
이범수	tal
이병규	base
이병근	foot
이병률	bask
이병석	bask
이병용	vol
이병천	pd
이병헌	tal
이병훈	pd
이보희	tal
이본	tal
이봉원	gag
이상군	base
이상규	bask
이상렬	vol
이상룡	mc
이상민	bask
이상민	pd
이상범	bask
이상벽	mc
이상아	tal
이상여	pd
이상영	bask
이상요	pd
이상우	sing
이상우	tal
이상욱	foot
이상운	gag
이상윤	base
이상윤	foot
이상은	sing
이상인	tal
이상태	foot
이상헌	foot
이상현	tal
이상현	wrscn
이상협	mc
이상호	mc
이상훈	base
이상흡	pd
이서진	tal
이석능	mc
이석우	pd
이석형	pd
이선령	wrscn
이선미	mc
이선영	wrscn
이선주	vol
이선진	mod
이선진	tal
이선태	pd
이선희	base
이선희	sing
이성미	gag
이성민	mc
이성수	pd
이성재	foot
이성재	tal
이성진	sing
이성희	vol
이세준	sing
이세창	tal
이소라	mod
이소라	sing
이소은	sing
이수동	vol
이수만	mc
이수만	sing
이수열	mc
이수영	sing
이숙자	vol
이순재	tal
이순철	base
이순철	pd
이순행	foot
이승렬	pd
이승면	pd
이승신	tal
이승연	mc
이승연	tal
이승엽	base
이승엽	foot
이승준	pd
이승철	sing
이승호	base
이승환	sing
이시일	pd
이아현	tal
이양구	pd
이언주	bask
이여춘	pd
이연경	sing
이연헌	pd
이영백	pd
이영애	tal
이영익	pd
이영자	gag
이영주	bask
이영준	bask
이영표	foot
이영하	tal
이영현	mc
이영호	mc
이영후	tal
이영훈	foot
이영희	pd
이예린	sing
이오규	pd
이완수	mc
이용	sing
이용발	foot
이용석	pd
이용우	foot
이용우	pd
이용하	foot
이우용	pd
이운재	foot
이웅모	pd
이웅호	gag
이원군	pd
이원승	gag
이원식	foot
이원용	pd
이원태	pd
이원혁	pd
이유리	tal
이유진	wrscn
이유호	pd
이유황	pd
이윤석	gag
이윤선	pd
이윤성	tal
이윤재	mc
이윤철	mc
이윤희	vol
이은규	pd
이은미	sing
이은아	bask
이은주	tal
이은주	wrscn
이은준	pd
이은택	pd
이은호	bask
이을규	pd
이을령	wrscn
이을용	foot
이응경	tal
이응주	pd
이응진	pd
이의정	tal
이익선	mc
이인	vol
이인구	vol
이인규	bask
이인균	pd
이인원	pd
이인표	bask
이일재	tal
이일화	tal
이임	vol
이임생	foot
이장관	foot
이장수	pd
이장우	mc
이재갑	pd
이재규	pd
이재룡	tal
이재상	pd
이재성	pd
이재영	sing
이재용	mc
이재용	pd
이재우	pd
이재원	pd
이재원	sing
이재은	tal
이재준	pd
이재철	foot
이재홍	mc
이재효	bask
이재후	mc
이재훈	bask
이재훈	sing
이적	sing
이정길	tal
이정래	bask
이정명	pd
이정민	mc
이정봉	sing
이정선	sing
이정섭	tal
이정수	gag
이정웅	pd
이정재	tal
이정철	vol
이정헌	pd
이정현	sing
이정현	tal
이정호	base
이정효	foot
이정훈	base
이정훈	pd
이제니	tal
이종만	pd
이종범	base
이종수	pd
이종수	tal
이종애	bask
이종엽	pd
이종원	sing
이종원	tal
이종태	mc
이종하	pd
이종학	wrscn
이종한	pd
이종혁	pd
이종호	wrscn
이주노	sing
이주복	mc
이주영	tal
이주일	gag
이주택	pd
이주호	sing
이주희	tal
이준용	pd
이지승	bask
이지연	mc
이지은	tal
이지현	sing
이지현	tal
이지혜	sing
이지훈	sing
이진	sing
이진규	pd
이진석	pd
이진섭	pd
이진아	wrscn
이진영	base
이진우	tal
이진욱	pd
이진행	foot
이진희	pd
이창수	bask
이창순	pd
이창행	pd
이창호	mc
이창훈	tal
이채훈	pd
이천규	mc
이천수	foot
이철균	pd
이춘석	foot
이충렬	pd
이충순	base
이충희	bask
이태기	pd
이태란	tal
이하원	gag
이학규	pd
이해수	wrscn
이해욱	pd
이해정	wrscn
이혁재	gag
이혁주	pd
이현경	tal
이현도	sing
이현숙	pd
이현우	mc
이현우	sing
이현주	bask
이현주	wrscn
이현지	vol
이현직	pd
이형걸	mc
이형모	pd
이형진	pd
이혜영	sing
이혜영	tal
이호	vol
이호성	base
이호준	base
이홍렬	gag
이효리	sing
이효희	vol
이훈	tal
이훈구	wrscn
이훈재	bask
이휘재	gag
이휘향	tal
이흥배	bask
이희구	gag
이희도	tal
이희수	base
이희우	wrscn
이희진	sing
인순이	sing
임경옥	tal
임경진	mc
임근배	bask
임도헌	vol
임동진	tal
임백천	mc
임백천	sing
임상아	sing
임상아	tal
임선동	base
임선미	vol
임성민	mc
임성훈	mc
임수민	mc
임순정	bask
임승원	wrscn
임영희	bask
임예진	tal
임우식	pd
임은경	mod
임장원	mc
임재범	sing
임재욱	sing
임재현	bask
임정명	bask
임종국	foot
임중용	foot
임지훈	sing
임창용	base
임창정	sing
임창정	tal
임채무	tal
임충	wrscn
임치환	pd
임태수	pd
임하룡	gag
임학송	pd
임현식	tal
임혜숙	pd
임호	tal
임효숙	vol
자니윤	mc
자두	sing
장광호	base
장광호	pd
장근수	pd
장기봉	foot
장기오	pd
장길황	pd
장나라	sing
장대일	foot
장덕균	wrscn
장동건	tal
장동선	pd
장명호	pd
장미희	tal
장민호	tal
장병철	vol
장사공	wrscn
장서희	tal
장선형	bask
장성호	base
장성환	pd
장소연	vol
장수봉	pd
장순욱	pd
장승재	pd
장승철	mc
장신영	tal
장영훈	foot
장용대	base
장용우	pd
장우혁	sing
장욱제	tal
장욱조	sing
장웅	mc
장웅상	pd
장윤숙	bask
장윤창	vol
장윤희	vol
장은영	mc
장재중	base
장종훈	base
장지현	foot
장진영	mc
장진영	tal
장진원	pd
장창곤	bask
장충길	pd
장태규	foot
장태연	pd
장헌호	foot
장혁	tal
장현호	mc
장형원	pd
장혜진	sing
장호연	base
장호일	sing
장호진	pd
전경준	foot
전관제	pd
전광렬	tal
전규삼	bask
전근표	base
전덕현	pd
전도연	tal
전범성	wrscn
전병하	pd
전산	pd
전성관	pd
전성홍	pd
전세권	pd
전연식	pd
전영록	sing
전영호	gag
전영화	pd
전용길	pd
전우근	foot
전우벽	mc
전운	tal
전원주	tal
전유성	gag
전육주	pd
전윤표	pd
전인권	sing
전인석	mc
전인화	tal
전재운	foot
전정업	pd
전정효	pd
전주원	bask
전준호	base
전지현	tal
전진	sing
전진수	pd
전창걸	gag
전창진	bask
전형수	bask
전혜진	tal
전희철	bask
정경구	pd
정경배	base
정경주	base
정경호	bask
정계춘	pd
정광민	foot
정광태	sing
정구근	bask
정구선	base
정규호	pd
정길용	foot
정길화	pd
정대숙	pd
정대영	vol
정대훈	foot
정도영	mc
정동남	tal
정동민	tal
정동천	pd
정동환	tal
정락영	bask
정량	pd
정명규	pd
정명원	base
정명환	tal
정문수	pd
정미나	vol
정미영	pd
정민철	base
정민태	base
정보석	tal
정봉섭	bask
정부미	gag
정상욱	bask
정상흠	base
정석균	mc
정석근	foot
정석원	sing
정선경	tal
정선민	bask
정선혜	vol
정선희	gag
정성갑	mod
정성모	tal
정성열	base
정성한	sing
정성환	tal
정성효	pd
정성후	pd
정성훈	base
정성희	wrscn
정세진	mc
정소녀	mc
정소녀	tal
정수근	base
정수나모	pd
정수라	sing
정수성	base
정수열	pd
정수영	tal
정수웅	pd
정수채	pd
정순길	pd
정순영	pd
정승배	pd
정승용	vol
정승호	tal
정애란	tal
정애리	tal
정연수	pd
정영규	base
정영숙	tal
정옥희	pd
정용석	sing
정용실	mc
정우성	tal
정욱	tal
정운봉	sing
정운용	tal
정웅인	tal
정원관	sing
정원기	foot
정원욱	base
정유석	foot
정유석	tal
정윤선	sing
정윤선	tal
정윤희	tal
정은선	vol
정은순	bask
정은승	mc
정은아	mc
정은임	mc
정은표	tal
정은희	vol
정을영	wrscn
정인	pd
정인교	bask
정인석	base
정재권	foot
정재근	bask
정재순	tal
정재용	sing
정재윤	gag
정재윤	sing
정재은	sing
정재헌	bask
정재환	gag
정재환	mc
정재훈	bask
정정희	wrscn
정종선	bask
정종수	mc
정종숙	sing
정종준	tal
정종현	pd
정주환	pd
정준	tal
정준하	gag
정준호	tal
정지영	mc
정지윤	vol
정진석	base
정진영	bask
정진영	tal
정진태	pd
정진호	base
정찬	tal
정찬우	gag
정창권	pd
정창근	foot
정창기	pd
정초영	pd
정춘수	pd
정태균	bask
정태춘	sing
정한신	bask
정한열	mc
정한용	tal
정현욱	base
정현택	base
정현호	foot
정형수	wrscn
정형진	pd
정혜경	mc
정혜선	tal
정혜영	tal
정혜자	pd
정혜정	tal
정혜진	bask
정호식	pd
정환식	pd
정효순	pd
정훈희	sing
정흥채	tal
정희섭	pd
제이	sing
조 에스터하스	wrscn
조PD	sing
조갑경	sing
조건진	mc
조경환	base
조경환	tal
조계현	base
조관우	sing
조광래	foot
조규수	base
조규제	base
조규찬	sing
조나단 헨슬레이	wrscn
조능희	pd
조대현	pd
조덕배	sing
조동기	bask
조동진	sing
조동현	bask
조명희	pd
조미령	tal
조미향	wrscn
조민기	tal
조민수	tal
조민아	sing
조병찬	base
조상현	bask
조성모	sing
조성민	base
조성애	bask
조성원	bask
조성찬	foot
조성호	pd
조성환	foot
조성훈	bask
조소혜	wrscn
조수영	pd
조승욱	pd
조신영	bask
조여정	tal
조연동	pd
조영남	sing
조용수	pd
조용원	tal
조용필	sing
조용호	pd
조우현	bask
조웅천	base
조윤환	foot
조윤희	tal
조은숙	tal
조의진	pd
조인성	base
조인성	tal
조재권	foot
조재민	foot
조재진	foot
조재현	tal
조정린	gag
조정선	wrscn
조정은	tal
조정현	foot
조정화	wrscn
조준묵	pd
조준호	foot
조진호	base
조진호	foot
조찬식	pd
조한선	pd
조헌모	pd
조현	foot
조현두	foot
조현재	tal
조형기	tal
조혜련	gag
조혜정	vol
조혜진	bask
조효송	wrscn
조효정	pd
조희진	pd
주동후	pd
주병대	pd
주병진	gag
주영훈	sing
주일청	pd
주진모	tal
주찬옥	wrscn
주철환	pd
주현	tal
주현미	sing
주형광	base
주희정	bask
지상열	gag
지상학	wrscn
지석원	pd
지성	tal
지수원	tal
지승현	mc
지영서	mc
지웅	pd
지장상	pd
지진희	tal
지형근	bask
지형욱	pd
진갑용	base
진미령	sing
진성호	bask
진순진	foot
진양혜	mc
진재영	tal
진준택	vol
진창욱	vol
진필중	base
진필홍	pd
진해인	pd
진효준	bask
진희경	tal
차동열	base
차두리	foot
차명주	base
차범근	foot
차범석	wrplay
차상현	vol
차승원	mod
차승원	tal
차인태	mc
차인표	tal
차주옥	tal
차태현	tal
차화연	tal
찰리 카우프만	wrscn
채리나	sing
채림	tal
채수일	pd
채시라	tal
채은정	sing
채재철	pd
채정안	sing
채정안	tal
채종국	base
채종범	base
채치성	pd
채형석	pd
천성일	sing
천은숙	bask
천지영	wrscn
천호진	tal
최강희	foot
최강희	tal
최거룩	foot
최경환	base
최경희	bask
최광희	vol
최금동	wrscn
최기문	base
최기성	foot
최남철	foot
최동수	base
최동원	base
최란	tal
최만호	base
최명균	pd
최명길	tal
최명도	bask
최명룡	bask
최무룡	tal
최문석	pd
최문식	foot
최미나	mc
최미선	tal
최민수	tal
최민식	tal
최민희	tal
최백호	sing
최병륜	pd
최병서	gag
최부영	bask
최불암	tal
최삼규	pd
최상덕	base
최상일	pd
최상훈	tal
최선규	mc
최선아	tal
최성국	foot
최성국	tal
최성록	pd
최성수	sing
최성용	foot
최성우	bask
최성일	pd
최성준	tal
최성호	gag
최성훈	gag
최세경	pd
최수완	wrscn
최수종	tal
최수지	tal
최수진	pd
최순호	foot
최승돈	mc
최승환	base
최애영	bask
최양락	gag
최연제	sing
최영근	pd
최영완	base
최영일	foot
최영주	mc
최영준	gag
최영필	base
최영호	pd
최영훈	foot
최용수	foot
최용원	pd
최용준	sing
최용준	tal
최용호	pd
최우철	pd
최원두	wrplay
최원정	mc
최원호	base
최월규	foot
최유라	tal
최유리	mc
최유리	tal
최윤경	mc
최윤락	mc
최윤석	pd
최윤영	mc
최윤영	tal
최율미	mc
최은경	mc
최은성	foot
최은희	tal
최이섭	pd
최익성	base
최인선	bask
최인수	wrscn
최인영	foot
최일언	base
최재성	tal
최재원	tal
최재혁	mc
최재형	pd
최재훈	sing
최정민	foot
최정우	base
최정원	sing
최정원	tal
최정윤	tal
최정자	sing
최종규	bask
최종덕	pd
최종수	pd
최종옥	vol
최종원	tal
최주립	pd
최주봉	tal
최준용	tal
최지민	pd
최지영	pd
최지우	tal
최진실	tal
최진영	sing
최진영	tal
최진용	pd
최진철	foot
최진희	sing
최창호	base
최천식	vol
최철우	foot
최태엽	pd
최태욱	foot
최태웅	vol
최태원	base
최태주	pd
최해식	base
최향남	base
최헌	sing
최현	foot
최현경	wrscn
최형만	gag
최화정	mc
최화정	tal
최훈재	base
최희섭	s
중계	s
바둑	s
MLB	s
만화	ea
축구	s
최희암	bask
최희준	sing
추금자	pd
추상미	tal
추성건	base
추소영	tal
추승균	bask
추신수	base
추자현	tal
쿠도 칸쿠로	wrscn
크리스김	sing
탁재훈	sing
태의경	mc
태진아	sing
태현실	tal
토니안	sing
패티김	sing
팽현숙	gag
편승엽	sing
표명일	bask
표민수	pd
표영준	mc
표영호	gag
표인봉	gag
표재순	pd
표필상	bask
하강일	pd
하광언	pd
하덕규	sing
하리수	mod
하명중	tal
하상윤	bask
하상훈	gag
하석주	foot
하용우	foot
하유미	tal
하유상	wrplay
하은철	foot
하인성	pd
하일용	foot
하종화	vol
하지원	tal
하지은	mc
하춘화	sing
하태강	pd
하태석	pd
하태진	pd
하헌목	pd
하희라	tal
한가인	tal
한경천	pd
한고은	tal
한광섭	mc
한규식	base
한기범	bask
한기붕	pd
한대수	sing
한대희	wrscn
한돌	sing
한동규	pd
한동준	sing
한명숙	sing
한복남	sing
한봉근	pd
한봉현	foot
한상구	foot
한상권	mc
한상길	pd
한상수	foot
한서경	sing
한석규	tal
한석준	mc
한선교	mc
한성주	mc
한수진	mc
한애경	tal
한영란	mc
한영애	sing
한영준	base
한예슬	mod
한옥근	wrplay
한용길	pd
한용덕	base
한유림	wrscn
한유미	vol
한은정	tal
한은진	tal
한인수	tal
한장석	vol
한재석	tal
한정국	foot
한정일	foot
한정희	pd
한지영	vol
한지일	tal
한지혜	tal
한진희	tal
한채영	tal
한철수	pd
한현선	bask
한혜숙	tal
한호섭	pd
한희	pd
한희석	vol
함소원	tal
함영대	pd
함학수	base
함형진	pd
허건영	pd
허기태	foot
허수경	mc
허영	bask
허영란	tal
허윤자	bask
허윤정	bask
허은정	mc
허재	bask
허정기	pd
허제정	foot
허종성	pd
허주	mc
허준호	tal
허참	mc
현고운	wrscn
현미	sing
현숙	sing
현영민	foot
현인	sing
현정주	pd
현주엽	bask
현철	sing
혜은이	sing
홍경민	sing
홍경인	tal
홍경일	tal
홍기섭	mc
홍기훈	gag
홍록기	gag
홍리나	tal
홍명보	foot
홍사붕	bask
홍상운	pd
홍서범	sing
홍성	pd
홍성덕	pd
홍성룡	pd
홍성민	pd
홍성완	pd
홍성주	pd
홍성흔	base
홍소연	mc
홍승기	tal
홍영희	wrscn
홍요섭	tal
홍원기	base
홍은원	wrscn
홍은철	mc
홍은희	tal
홍자람	wrscn
홍종명	pd
홍종화	pd
홍중기	tal
홍진경	mod
홍진경	tal
홍진아	wrscn
홍창욱	pd
홍평길	wrscn
홍학표	tal
홍현우	base
홍현희	bask
홍희경	pd
환희	sing
황금심	sing
황기순	gag
황동성	pd
황명화	vol
황문용	bask
황병일	base
황상무	mc
황선길	pd
황선숙	mc
황선홍	foot
황성인	bask
황수경	mc
황수정	tal
황순영	wrscn
황순혜	bask
황승주	foot
황승환	gag
황신혜	tal
황영빈	wrscn
황유선	mc
황유성	pd
황유하	bask
황윤석	sing
황은진	pd
황인뢰	pd
황인영	tal
황인용	mc
황정민	foot
황정민	mc
황정민	tal
황정순	tal
황진원	bask
황현정	mc
황효선	pd
후인정	vol
히딩크	foot
KBS	지상파
한국 방송	지상파
한국방송	지상파
KBS 1	지상파
KBS1	지상파
한국 방송 1번	지상파
KBS 2	지상파
KBS2	지상파
한국 방송 2번	지상파
MBC	지상파
문화 방송	지상파
문화방송	지상파
EBS	지상파
교육 방송	지상파
EBS 교육 방송	지상파
SBS	지상파
서울 방송	지상파
MBN	케이블
매일경제	케이블
MCN무협영화	케이블
MCN	케이블
CMB충청방송3	케이블
CMB3	케이블
CMB	케이블
충청방송	케이블
우리홈쇼핑	케이블
CJ홈쇼핑	케이블
CJ	케이블
LG홈쇼핑	케이블
CMB충청방송1	케이블
CMB1	케이블
충청방송1	케이블
TJB대전방송	케이블
TJB	케이블
현대홈쇼핑	케이블
HMALL	케이블
M.NET	케이블
엠넷	케이블
HEN(홀마크)	케이블
HEN	케이블
홀마크	케이블
HEN홀마크	케이블
HEN 홀마크	케이블
헨홀마크	케이블
온스타일	케이블
농수산홈쇼핑	케이블
농수산	케이블
CMB충청방송2	케이블
CMB2	케이블
충청방송2	케이블
MIN	케이블
매일방송	케이블
MIN 매일방송	케이블
OCN	케이블
오씨엔	케이블
CNTV	케이블
씨엔티비	케이블
YTN	케이블
와이티엔	케이블
MCN	케이블
엠씨엔	케이블
시네마TV	케이블
시네마티비	케이블
한우리시네마	케이블
한우리	케이블
휴먼TV	케이블
휴먼티비	케이블
휴먼	케이블
어린이TV	케이블
대교	케이블
대교티비	케이블
온게임넷	케이블
캐치온	케이블
캐치온플러스	케이블
MBC무비	케이블
Home CGV	케이블
CGV	케이블
홈씨지브이	케이블
씨지브이	케이블
DCS/DTN드라마	케이블
디씨에스	케이블
디티엔	케이블
EBS plus1	케이블
EBS plus2/Etn	케이블
SBS드라마플러스	케이블
에스비에스 드라마플러스	케이블
MBC드라마넷	케이블
엠비씨 드라마넷	케이블
Super Action	케이블
슈퍼 액션	케이블
코메디TV	케이블
코메디티비	케이블
FOOD채널	케이블
푸드 채널	케이블
KMTV	케이블
SBS스포츠	케이블
KBS SKY 스포츠	케이블
SBS골프	케이블
MBC-ESPN	케이블
엠비씨 이에스피엔	케이블
JEI스스로방송	케이블
제이 방송	케이블
제이스스로 방송	케이블
투니버스	케이블
바둑TV	케이블
바둑티비	케이블
GTV	케이블
히스토리채널/Q채널	케이블
히스토리채널	케이블
Q채널	케이블
큐채널	케이블
네셔널지오그래픽	케이블
동아	케이블
스파이스	케이블
한국경제	케이블
메디티비	케이블
메디TV	케이블
메디	케이블
MBC게임	케이블
참	케이블
기독교	케이블
기독교티비	케이블
기독교TV	케이블
기독교방송	케이블
불교TV 	케이블
불교방송	케이블
불교티비	케이블
평화방송	케이블
방송대학TV(OUN)	케이블
방송대학TV	케이블
OUN	케이블
방송대학방송	케이블
방송대학티비	케이블
육아TV	케이블
XTM	케이블
e채널	케이블
이채널	케이블
애니원	케이블
CNN	케이블
디스커버리채널	케이블
디스커버리	케이블
Qwiny	케이블
NHK World Premium	케이블
아리랑TV	케이블
아리랑	케이블
KTV	케이블
도올특강	CL
우리는 누구인가	CL
도올특강 우리는 누구인가	CL
MBC도올특강 우리는 누구인가	CL
도올	CL
MBC소설극장	D
열정	D
MBC소설극장 열정	D
올림픽 배구	S
올림픽 배구 예선전	S
2004 올림픽 배구 예선전	S
여자오픈 골프	S
여자오픈 골프 제 1라운드	S
여자오픈 골프 제 2라운드	S
여자오픈 골프 최종일	S
MBC 여자오픈 골프	S
X-CANVAS 여자오픈 골프	S
2004 MBC X-CANVAS 여자오픈 골프 제1라운드	S
2004 MBC X-CANVAS 여자오픈 골프 제2라운드	S
2004 MBC X-CANVAS 여자오픈 골프 최종일 (용인)	S
여자오픈	S
김병현 선발경기	SBM
김병현	SBN
2004 MLB 김병현 선발경기 토론토:보스톤 (토론토 위성Live)	SBM
김선우 선발경기	SBM
김선우	SBN
2004 MLB 김선우 선발경기 밀워키:몬트리올 (밀워키 위성Live)	SBM
세상탐험	C
6mm 세상탐험	C
결혼하고 싶은 여자	D
고향은 지금	C
교통혁명 고속철시대	Q
귀여운 여인	DD
태랑	EA
기파이터 태랑	EA
꼬마마법사	EA
꼬마마법사 레미 f	EA
꼭 한번 만나고 싶다	C
내 친구들의 세상	EH
네 꿈을 펼쳐라	C
늘 푸른 인생	C
두근두근 체인지	ES
물꽃마을 사람들	D
불새	DO
뽀뽀뽀	EH
사과나무	C
사람 사진으로 쓰는 이야기	C
대한민국은 통화중	C
섹션TV	EN
연예통신	EN
섹션TV 연예통신	EN
아주 특별한 아침	C
음악캠프	EM
이슈＆이슈	C
토요일엔 떠나볼까	C
화제만발 일요일	C
화제집중	C
수요예술무대	EM
스몰빌	Z
스튜어트 리틀	EA
스포츠 복권	Z
행운을 쏴라	Z
스포츠 복권 행운을 쏴라	Z
스포츠 하이라이트	NS
시사매거진 2580	CC
사실은	CC
신강균의 뉴스 서비스	CC
신강균의 뉴스서비스 사실은	CC
신비한 TV	E
서프라이즈	E
신비한 TV 서프라이즈	E
실화극장	D
죄와 벌	D
실화극장 죄와 벌	D
심야스페셜	Q
다름살라의 아이들	Q
심야스페셜 (1) 다름살라의 아이들	Q
심야스페셜 (2) 다름살라의 아이들	Q
아가씨와 아줌마 사이	ES
아하! 그렇구나	EH
알렉스의 모험	EA
베스트극장	D
앙코르 베스트극장	D
와! e-멋진 세상	C
요리보고 세계보고	C
놀러와	E
유재석 김원희의 놀러와	E
일요일 일요일밤에	EC
장미의 전쟁	DW
전파견문록	E
장애인 체전	S
전국 장애인 체전	S
좌식배구	S
제24회 전국 장애인 체전 &lt;좌식배구 (전주)&gt;	S
주말의 명화	M
줌인 게임천국	E
즐거운 문화읽기	C
지구촌 리포트	N
질풍노도 라이벌	Z
찾아라! 맛있는 TV	C
논스톱	ES
논스톱 4	ES
청춘시트콤 논스톱 4	ES
비디오 여행	E
출발! 비디오여행	E
코미디 하우스	EC
퀴즈가 좋다	EQ
퀴즈가 좋다 2	EQ
퀴즈가 좋다 Ⅱ	EQ
퀴즈	EQ
타임머신	E
토크쇼 임성훈과 함께	C
통일전망대	C
행복주식회사	E
희망한국	C
희.망.한.국	C
과학수사대	D
CSI 과학수사대	D
100분 토론	CD
MBC 100분 토론	CD
가요콘서트	EM
MBC 가요콘서트	EM
금요영화천국	M
MBC 뉴스	N
MBC 뉴스24	N
뉴스데스크	N
MBC 뉴스데스크	N
뉴스투데이	N
MBC 뉴스투데이	N
MBC 뉴스투데이 (1부)	N
MBC 뉴스투데이 (2부)	N
MBC 뉴스투데이 (3부)	N
베스트극장	D
MBC 베스트극장	D
MBC 베스트극장 달수 아들 과외하다	D
MBC 스페셜	C
MBC 스페셜 5월은 끝났는가	C
스포츠뉴스	NS
MBC 스포츠뉴스	NS
그랑프리 자동차 경주대회	S
MBC 스포츠특선 2004 MBC 그랑프리 자동차 경주대회	S
PD수첩	CC
TV속의 TV	CC
놀라운 세상	E
TV특종 놀라운 세상	E
가을	date
가을날	date
가을철	date
간밤	date
거년	date
광복절	date
그끄러께	date
그끄저께	date
그끄제	date
그저께	date
그제	date
근간	date
근년	date
근래	date
글피	date
금년	date
금년도	date
금일	date
낮	date
내년	date
내년도	date
내달	date
내일 모레	date
내일	date
내일	date
내일모레	date
늦 봄	date
늦 겨울	date
늦 여름	date
늦 가을	date
늦가을	date
늦겨울	date
늦봄	date
늦여름	date
다음달	date
다음 달	date
다음 주말	date
다음 주	date
다음주	date
다음주말	date
대낮	date
명년	date
명일	date
모레	date
밤	date
밤중	date
봄	date
봄날	date
봄철	date
상반기	date
새벽	date
새벽녘	date
성탄일	date
성탄절	date
식목일	date
아침	date
아침녘	date
야간	date
야밤	date
어린이 날	date
어린이날	date
어버이 날	date
어버이날	date
어저께	date
어제 저녁	date
어제 밤	date
어제	date
어제밤	date
어제저녁	date
어젯 밤	date
어젯밤	date
엊그저께	date
엊그제	date
엊저녁	date
여름날	date
여름낮	date
여름철	date
연말	date
오늘	date
올 봄	date
올 여름	date
올 가을	date
올가을	date
올봄	date
올여름	date
올해	date
요사이	date
요새	date
요즈음	date
요즘	date
이달	date
이번달	date
이번 달	date
이번 주말	date
이번 주	date
이번주	date
이번주말	date
이전 주말	date
자정	date
작년	date
재작년	date
저녁	date
전년	date
전년도	date
점심	date
점심때	date
정오	date
제헌절	date
종일	date
주말	date
주일	date
중순	date
지금	date
지난 달	date
지난 해	date
지난 주	date
지난 주말	date
지난달	date
지난 달	date
지난주	date
지난주말	date
지난해	date
초가을	date
초겨울	date
초봄	date
초순	date
초여름	date
초저녁	date
하반기	date
하순	date
한겨울	date
한밤중	date
한여름	date
현장르포 제3지대 150인의 청소원정대 대마도에 가다	C
현장르포 제3지대	C
현장르포	C
제3지대	C
[특집] MBC 100분 토론 17대 국회개원, 국회의원들과 함께	C
[특집] MBC 100분 토론 17대 국회개원, 국회의원들과 함께	C
MBC 100분 토론	C
100분 토론	C
100분토론	C
MBC 뉴스 투데이	N
뉴스 투데이	N
뉴스투데이	N
MBC 뉴스투데이	N
생방송 모닝 와이드	C
모닝 와이드	C
모닝와이드	C
생방송 세상의 아침 1부	C
세상의아침	C
세상의 아침	C
일요특집 생방송 모닝와이드	C
생방송 모닝와이드	C
모닝와이드	C
잘먹고 잘사는법	C
잘먹고잘사는법	C
수목드라마 4월의 키스	D
4월의 키스	D
4월의키스	D
MBC 다큐멘터리 888번지 품바	Q
MBC 다큐멘터리	Q
MBC 스포츠	S
KBS 라이브러리 KBS 월드넷	C
KBS 라이브러리	C
KBS 월드넷	C
KBS라이브러리	C
KBS월드넷	C
SBS 스포츠	S
MBC수목미니시리즈 결혼하고 싶은 여자	D
결혼하고 싶은 여자	D
결혼하고싶은여자	D
KBS 일일연속극 금쪽같은 내새끼	D
금쪽같은 내새끼	D
금쪽같은내새끼	D
TV 문화지대 낭독의 발견	C
TV 문화지대	C
TV문화지대	C
KBS 독립영화관 노동자다 아니다	M
KBS 독립영화관	M
KBS독립영화관	M
청춘 시트콤 논스톱 4	D
논스톱 4	D
논스톱4	D
논스톱	D
일일시트콤 달래네 집	D
달래네 집	D
달래네집	D
천연 시트콤 대단한 가족	D
대단한 가족	D
대단한가족	D
SBS스포츠	S
KBS 라이브러리 도전 역사퀴즈	C
도전 역사퀴즈	C
도전역사퀴즈	C
역사퀴즈	C
MBC 특별기획 다큐 독일로 간 광부, 간호사들	Q
MBC 특별기획 다큐	Q
MBC 특별기획	Q
MBC 다큐	Q
독일로 간 광부, 간호사들	Q
미니 시트콤 두근두근 체인지	D
두근두근 체인지	D
두근두근체인지	D
수요기획 또 하나의 교육, 급식	C
수요기획	C
SBS 스페셜 로키 안데스 아메리카 대탐험 2부	C
SBS 스페셜	C
SBS스페셜	C
[특집] 오페라 리골렛토	EM
오페라 리골렛토	EM
KBS 라이브러리 리얼토크 김동건의 한국 한국인	C
KBS 라이브러리 리얼토크	C
라이브러리 리얼토크	C
한국한국인	C
시네클럽 마지막 지하철	M
시네클럽	M
명화극장 말레나	M
명화극장	M
말레나	M
대하드라마 무인시대	D
무인시대	D
KBS라이브러리 문화탐구 스승과 제자	C
일요 아침 드라마 물꽃 마을 사람들	D
물꽃 마을 사람들	D
TV 문화지대 미술관 가는길	C
TV 문화지대	C
인물 현대사 6월 시민항쟁 특집 박종철-탁치니 억하고 죽다	C
인물 현대사	C
성장 드라마 반올림 #	D
반올림 #	D
성장 드라마 반올림 #	D
한민족 리포트 반항아 청년사업가 되다-LA 피터김	C
한민족 리포트	C
행복충전 백세인	C
백세인	C
SBS창작 3D애니메이션 범퍼킹 재퍼	EA
심야특선 보디가드	D
심야특선	D
특별기획 한중합작 드라마 북경 내사랑	D
북경 내사랑	D
북경내사랑	D
MBC 월화드라마 불새	D
불새	D
주말연속극 사랑을 할꺼야	D
사랑을 할꺼야	D
사랑을할꺼야	D
신강균의 뉴스서비스 사실은…	C
사실은…	C
사실은	C
환경스페셜 생명의 조건 산소 02	Q
환경스페셜	Q
드라마 스페셜 섬마을 선생님	D
섬마을 선생님	D
섬마을선생님	D
SBS 일일드라마 소풍가는 여자	D
소풍가는 여자	D
소풍가는여자	D
제16회 TV 바둑 아시아 선수권대회 송태곤7단: 고바야시 고이치9단	SC
외화시리즈 스몰빌	D
외화시리즈	D
스몰빌	D
명랑가족 시트콤 아가씨와 아줌마 사이	D
아가씨와 아줌마 사이	D
아가씨와아줌마사이	D
아침 드라마 아름다운 유혹	D
아름다운 유혹	D
아름다운유혹	D
청춘드라마 알게 될 거야	D
알게 될 거야	D
알게될거야	D
일일시트콤 스페셜 압구정 종가집	D
압구정 종가집	D
압구정종가집	D
KBS 주말드라마 애정의 조건	D
애정의 조건	D
애정의조건	D
KBS 라이브러리 역사 스페셜	C
역사스페셜	C
MBC 소설극장 열정	D
열정	D
그리스로마신화 올림포스가디언	EA
그리스로마신화	EA
일일연속극 왕꽃 선녀님	D
왕꽃 선녀님	D
왕꽃선녀님	D
MBC 도올특강 우리는 누구인가	C
도올특강 우리는 누구인가	C
도올특강	C
우리는 누구인가	C
유니미니펫	EA
HD 다큐멘터리	Q
TV 문화지대 음악 속으로	C
TV 문화지대	C
영화 특급 의뢰인	M
영화 특급	M
영화특급	M
의뢰인	M
특집 이경규의 굿타임	E
이경규의 굿타임	E
굿타임	E
특집 다큐멘터리 이란 지진 그후	Q
특집 다큐멘터리	Q
이란 지진 그후	Q
KBS 라이브러리 인물탐구 조영남이 만난 사람	C
인물탐구	C
세계의 다큐멘터리 땅끝으로의 여행 잃어버린 성궤를 찾아서	Q
세계의 다큐멘터리	Q
SBS 주말드라마 작은 아씨들	D
작은 아씨들	D
작은아씨들	D
SBS 대하드라마 장길산	D
장길산	D
중계방송 제17대 국회 개원식	C
MBC 주말의 명화 조용한 가족	M
주말의 명화	M
실화극장 죄와 벌	C
죄와 벌	C
실화극장	C
TV 소설 찔레꽃	D
TV 소설	D
토요명화 천방지축	M
토요명화	M
SBS 스포츠	S
SBS 아침연속극 청혼	D
청혼	D
드라마 스페셜 파란만장 미스김 10억 만들기	D
파란만장 미스김 10억 만들기	D
파란만장미스김10억만들기	D
미스김10억 만들기	D
SBS 특별기획 파리의 연인	D
파리의 연인	D
파리의연인	D
KBS 특별기획 한국사회를 말한다	C
KBS 특별기획	C
KBS특별기획	C
TV 문화지대 한국의 미	C
TV 문화지대	C
TV문화지대	C
17대 국회개원기념 함께 뛴다! 희망한국!	C
희망한국!	C
TV동화 행복한 세상	C
TV동화	C
행복한 세상	C
스포츠 복권 행운을 쏴라	E
스포츠 복권	E
스포츠복권	E
행운을 쏴라	E
행운을쏴라	E
MBC 금요영화천국 헤어 드레서	M
금요영화천국	M
영화천국	M
헤어 드레서	M
헤어드레서	M
대추나무 사랑걸렸네 화면해설방송	D
대추나무 사랑걸렸네	D
대추나무사랑걸렸네	D
KBS 라이브러리 환경 스페셜	C
SBS스포츠 2006 독일월드컵남미예선 아르헨티나:파라과이 美 LPGA 켈로그 키블러 클래식(3R)	S
SBS스포츠	S
17대 국회 개원식	C
2004 강릉 국제 관광민속제	C
6mm 세상탐험	C
세상탐험	C
6시 내고향	C
6시내고향	C
CSI 과학수사대	D
CSI과학수사대	D
과학수사대	D
CSI	D
KBS 8 뉴스타임	N
뉴스타임	N
KBS 뉴스	N
KBS뉴스	N
KBS 뉴스 5	N
뉴스 5	N
뉴스5	N
KBS 뉴스 8	N
뉴스 8	N
뉴스8	N
KBS 뉴스 9	N
뉴스 9	N
뉴스9	N
KBS 뉴스 네트워크	N
뉴스 네트워크	N
뉴스네트워크	N
KBS 뉴스광장	N
뉴스광장	N
KBS 뉴스라인	N
뉴스라인	N
KBS 예술극장	C
예술극장	C
KBS 일요스페셜	C
일요스페셜	C
KBS 정오뉴스	N
정오뉴스	N
KBS 특강	C
KBS특강	C
MBC 가요콘서트	EM
가요콘서트	EM
MBC 뉴스	N
뉴스	N
MBC 뉴스 24	N
뉴스 24	N
뉴스24	N
MBC 뉴스데스크	N
뉴스데스크	N
MBC 베스트극장	D
베스트극장	D
MBC 스포츠 뉴스	N
스포츠 뉴스	N
스포츠뉴스	N
NGO 특강	C
PD수첩	C
SBS 8 뉴스	N
SBS TV 특강	C
TV특강	C
SBS 가요쇼	EM
가요쇼	EM
가요쇼	EM
SBS 골프	S
골프	S
SBS 나이트라인	N
나이트라인	N
SBS 뉴스	N
SBS 뉴스퍼레이드	N
뉴스퍼레이드	N
SBS 대토론 - 이것이 여론이다	C
이것이 여론이다	C
이것이여론이다	C
SBS 스포츠 중계석	S
스포츠 중계석	S
SBS 시사진단	C
시사진단	C
TV 동물농장	C
동물농장	C
TV 생활법정	C
생활법정	C
TV 속의 TV	C
TV속의TV	C
TV 아름다운 가게	C
아름다운 가게	C
TV 책을 말하다	C
TV책을말하다	C
TV는 사랑을 싣고	E
TV는사랑을싣고	E
TV동화 행복한 세상	EA
TV비평 시청자 데스크	C
시청자데스크	C
TV쇼 진품명품	E
TV쇼진품명품	E
TV유치원 하나,둘,셋	EH
TV유치원	EH
하나,둘,셋	EH
VJ 특공대	C
VJ클럽	Q
가요무대	EM
가족오락관	E
개그콘서트	E
검정고무신	EA
게임쇼! 즐거운 세상	E
결정! 맛대맛	E
맛대맛	E
경제, 아는 만큼 보인다	CE
경제전망대	CE
고스트 바둑왕	SC
고향은 지금	C
국악 한마당	C
그것이 알고 싶다	Q
그곳에 가고 싶다	Z
금요 컬처 클럽	C
기파이터 태랑	EA
김승현 정은아의 좋은 아침	C
김용만 신동엽의 즐겨찾기	E
꼬꼬마 텔레토비	EH
꼬마 마법사 레미	EA
꼭 한번 만나고 싶다	C
꿈의 피라미드	Z
남북의 창	C
내 친구들의 세상	EH
네 꿈을 펼쳐라	D
네트워크 현장! 고향이 보인다	C
고향이 보인다	C
네티비	EA
논스톱4	D
농어촌 네트워크 싱싱 토요일	C
싱싱 토요일	C
농어촌 네트워크	C
뉴스와 생활경제	N
뉴스추적	N
늘 푸른 인생	C
대추나무 사랑걸렸네	D
대추나무사랑걸렸네	D
도전 1000곡	E
도전 골든벨	E
도전! 주부가요스타	EM
주부가요스타	EM
도전! 지구탐험대	Q
지구탐험대	Q
드라마 시티	D
디즈니 만화동산	EA
디지털미술관	C
무엇이든 물어보세요	C
무한 음악지대	EM
물은 생명이다	Q
뮤직뱅크	EM
미디어 포커스	C
백만불 미스터리	E
부부클리닉 사랑과 전쟁	D
사랑과 전쟁	D
부부클리닉	D
비타민	CH
뽀뽀뽀	EH
사과나무	C
사람 사진으로 쓰는 이야기	C
사람사진으로쓰는이야기	C
사랑의 가족	C
사랑의가족	C
사랑의 리퀘스트	C
사랑의리퀘스트	C
사랑의 카네이션 기행	C
새천년 건강체조	C
건강체조	C
샌디베이의 악동들	D
생로병사의 비밀	C
생방송 KBS 저널	C
KBS 저널	C
MC 서바이벌	E
MC서바이벌	E
생방송 MC 서바이벌	E
생방송 대한민국은 통화중	C
대한민국은 통화중	C
대한민국은통화중	C
생방송 세븐데이즈	C
세븐데이즈	C
생방송 섹션TV 연예통신	E
섹션TV 연예통신	E
섹션TV	E
생방송 시사 투나잇	C
시사 투나잇	C
시사투나잇	C
생방송 심야토론	C
심야토론	C
생방송 아주 특별한 아침	C
아주 특별한 아침	C
생방송 음악캠프	EM
음악캠프	EM
생방송 이슈 &amp; 이슈	C
이슈 &amp; 이슈	C
생방송 퀴즈가 좋다	Z
퀴즈가 좋다	Z
생방송 토요일엔 떠나볼까	C
토요일엔 떠나볼까	C
생방송 투데이	C
생방송 한밤의 TV연예	E
한밤의 TV연예	E
TV연예	E
생방송 화제만발 일요일	E
화제만발 일요일	E
생방송 화제집중	C
화제집중	C
성공예감 경제특종	CE
세계명작동화	EA
세상에서 가장 아름다운 여행	C
세상은 넓다	C
솔로몬의 선택	C
쇼! 파워 비디오	E
쇼!파워 비디오	E
쇼! 행운열차	E
쇼!행운열차	E
수요 예술무대	EM
수요예술무대	EM
순간포착 세상에 이런일이	E
세상에 이런일이	E
세상에이런일이	E
스튜어트 리틀	EA
스튜어트리틀	EA
스펀지	C
스포츠 빅 이벤트	S
빅이벤트	S
스포츠 세상	S
스포츠 스포츠	S
스포츠스포츠	S
스포츠 와이드	S
스포츠와이드	S
스포츠 중계석	S
스포츠중계석	S
스포츠 하이라이트	N
스포츠하이라이트	N
시사매거진 2580	C
2580	C
시청자 칼럼 우리사는 세상	C
우리사는 세상	C
신나는 과학나라	EH
신나는과학나라	EH
신비한 TV 서프라이즈	E
서프라이즈	E
실속TV 주부경제학	CE
주부경제학	CE
실제상황! 토요일	E
심야 스페셜	Q
심야스페셜	Q
쏙쏙! 어린이 경제 나라	EH
아짱쥬리	EA
아침마당	C
아하! 그렇구나	EH
알렉스의 모험	EA
앙코르 드라마 시티	D
드라마 시티	D
야심만만 만명에게 물었습니다	E
야심만만	E
어린이 뉴스탐험	EH
언제나 청춘	CH
여기는 TV 정보센터	C
여자 플러스	C
여자플러스	C
연예가 중계	E
연예가중계	E
열려라 동요세상	EH
열린 TV 시청자 세상	C
시청자 세상	C
열린음악회	EM
열린채널	C
영상기록 병원 24시	Q
오늘의 스포츠	S
오픈 스튜디오	C
와! e멋진세상	C
e멋진세상	C
외국인 대설전	C
요리보고 세계보고	CO
우리말 겨루기	C
우주소년 아톰	EA
아톰	EA
울라 불라 블루짱	EH
웃음을 찾는 사람들	E
웃찾사	E
원피스	EH
유재석 김원희의 놀러와	E
놀러와	E
유희왕	EA
윤도현의 러브레터	EM
러브레터	EM
이것이 인생이다	Q
이홍렬, 박주미의 여유만만	C
여유만만	C
인간극장	C
인간극장	Q
일요 스포츠	S
일요일 일요일밤에	E
일밤	E
일요일은 101%	C
일요일이 좋다	E
일요진단	C
재미있는 TV천국	E
재미있는TV천국	E
재미있는 동물의 세계	C
동물의세계	C
저요! 저요!	EH
전국노래자랑	E
전파견문록	E
접속 무비월드	E
접속무비월드	E
무비월드	E
제 28회 아테네 올림픽 성화환영식	Z
좋은나라 운동본부	C
주간기획 스포츠 매거진	N
스포츠 매거진	N
주부 세상을 말하자	C
주주클럽	E
줌인 게임천국	Z
중계방송 17대 국회 개원식	C
즐거운 문화읽기	C
즐거운문화읽기	C
지구촌 뉴스	N
지구촌뉴스	N
지구촌 리포트	C
지구촌리포트	C
진실게임	E
질풍노도 라이벌	E
질풍노도라이벌	E
찾아라! 맛있는 TV	CO
맛있는 TV	CO
청춘 신고합니다	C
체험 삶의 현장	C
체험삶의현장	C
체험! 지구촌 홈스테이	C
추적 60분	Q
추적60분	Q
출발! 비디오 여행	E
출발!비디오여행	E
취재파일 4321	C
코미디 하우스	E
코미디하우스	E
퀴즈 막상막하	EH
퀴즈! 대한민국	Z
퀴즈탐험 신비의 세계	E
클릭 날씨 @ 생활	NW
타임머신	E
토요 영화 탐험	C
토크쇼 임성훈과 함께	C
토크쇼 임성훈과 함께	E
통일 전망대	C
특집 여의도 일번지	Z
특집 인연 버라이어티 로그인	E
포켓몬스터AG	EA
포트리스	EA
폭소클럽	E
피플! 세상속으로	C
세상속으로	C
학교전설	C
한부모 가족돕기 F콘서트 2004 1부	EM
한부모 가족돕기 F콘서트 2004 2부	EM
해피 투게더	E
해피투게더	E
행복주식회사	C
현장르포 3지대	Q
휴먼스토리 여자	C
희.망.한.국	C
희망한국	C
